###################################
#S..#.....#.......#.....#.........#
#.#.#.#.###.#####.#.###.#.#######.#
#.#...#...#.....#.#.#.#.#.......#.#
#.#######.#####.#.#.#.#.#######.#.#
#.#.......#...#.#.#.#.#.....#...#.#
#.#.#######.#.#.#.#.#.#####.#.###.#
#...#.......#...#...#.....#.#...#.#
#.###.#############.#####.#.###.#.#
#.#...#.......#...#.#...#.#...#.#.#
#.#.###.#####.#.#.#.#.#.#.###.#.#.#
#.#.#...#...#...#.#.#.#.#.#...#.#.#
#.#.#.###.#.#####.#.#.#.#.#.###.#.#
#.#.#.#...#.......#.#.#.#...#...#.#
#.#.#.#.###########.#.#.#####.###.#
#.#.#.#.#.........#.#.#.....#...#.#
#.#.#.#.#.#######.#.#.#####.###.#.#
#.#.#.#.#.#.....#.#.#.....#...#.#.#
#.#.#.#.#.#.###.#.#.#####.###.#.#.#
#.#.#.#.#.#.#.#.#.#.....#...#.#.#.#
#.#.#.#.#.#.#.#.#.#.#.#.###.#.#.#.#
#.#.#.#.#.#.#.#.#.#.#.#.#...#.#.#.#
#.#.#.#.#.#.#.#.#.#.#.#.#.###.#.#.#
#.#.#.#.#.#.#.#.#.#.#.#.#.#.....#.#
#.#.#.#.#.#.#.#.#.#.#.#.#.#######.#
#...#...#...#...#...#............E#
###################################