###############
#S..#.........#
#.#.#.#######.#
#.#...#....##.#
#.#####.##.##.#
#.#...#..#.##.#
#.#.#.##.#.##.#
#...#....#.##.#
#.#######.#.#.#
#.#.....#.#.#.#
#.#.###.#.#.#.#
#...#...#...#E#
###############