###############
#S..#........#
#.#.#.######.#
#.#...#....#.#
#.#####.##.#.#
#.#...#..#.#.#
#.#.#.##.#.#.#
#...#....#.#.#
#.#######.#.#.#
#.#.....#.#.#.#
#.#.###.#.#.#.#
#...#...#...#E#
###############