#######
#S#...#
#.#.#.#
#.#.#E#
#.....#
#######